{
    "F4": 4,
    "F3": 3,
    "F2": 2,
    "F5": 5,
    "B1": -1,
    "F7": 7,
    "F6": 6,
    "F1": 1,
    "F8": 8
}